10
XXXXXXXXX
X00000000
X0XXX00XX
X0XXX000X
X0XXX000X
X0XXX000X
X0000000X
X00XXXXXX
X000000*X
XXXXXXXXX
